H,H,H,H,H,H,H,H,H,H
W,W,W,W,W,H,H,H,P,H
W,W,W,W,W,H,H,H,H,H
W,W,W,W,W,H,W,W,W,W
H,H,H,H,H,H,H,H,H,H
W,W,W,W,W,H,W,W,W,W
W,H,T,H,W,H,H,W,W,W
W,W,H,W,W,W,H,H,H,H
W,W,H,W,W,W,W,W,W,H
W,W,H,W,H,H,H,H,W,H
W,W,T,H,H,H,H,H,H,H
W,W,W,W,H,H,H,H,W,H
W,W,W,W,W,W,W,W,W,H
W,W,W,W,W,H,H,H,H,H
W,W,W,W,W,H,H,H,H,H
W,H,H,H,W,H,H,H,H,H
W,H,H,H,W,W,W,W,W,H
W,H,H,H,H,H,H,H,H,H